.G...........
.............
.G...........
.G...........
.G...........
.G.....b.....
.G....bcb....
.G...bcwcb...
.G..bcwcwcb..
.G.bcwcScwcb.
.G..bcwcwcb..
.G...bcwcb...
.G....bcb....
.G.....b.....
.G...........
.G...........
.G...........
.GGGGGGGGGGGG
.............
.............
.............
.............
.............
.............
.............
.............
.............
.............
.............
.............
