.............
.............
w............
wr...........
wrc..........
wrcg.........
wrcgr........
wrcgrb.......
wrcgrbp......
wrcgrbpy.....
wrcgrbpyw....
wrcgrbpywo...
wrcgrbpywoc..
wrcgrbpywocg.
SSSSSSSSSSSSr
.............
.............
.............
.............
.............
.............
.............
.............
.............
.............
.............
.............
.............
.............
.............
