.............
.............
.............
ggggggggggggg
.............
wwwGGGGGGGGGG
.............
rrrrrrrrrrrrr
.............
GGGGGGGGGGwww
.............
rrrrrrrrrrrrr
.............
bbbGGGGGGGGGG
.............
ccccccccccccc
.............
GGGGGGGGGGccc
.............
.............
.............
.............
.............
.............
.............
.............
.............
.............
.............
.............
