.............
.............
...y.....y...
...y.....y...
....y...y....
....y...y....
...wwwwwww...
...wwwwwww...
..wwrwwwrww..
..wwrwwwrww..
.wwwwwwwwwww.
.wwwwwwwwwww.
.wwwwwwwwwww.
.w.wwwwwww.w.
.w.w.....w.w.
.w.w.....w.w.
....ww.ww....
....ww.ww....
.............
.............
.............
.............
.............
.............
.............
.............
.............
.............
.............
.............
