.............
.............
.............
b.r.g.c.g.r.b
b.r.g.c.g.r.b
b.r.g.c.g.r.b
b.r.g.c.g.r.b
b.r.g.c.g.r.b
b.GoGoGoGoG.b
b.r.g.c.g.r.b
b.r.g.c.g.r.b
b.r.g.c.g.r.b
b.r.g.c.g.r.b
o.o.o.o.o.r.o
b.r.g.c.g.r.b
.............
.............
.............
.............
.............
.............
.............
.............
.............
.............
.............
.............
.............
.............
.............
