.............
.............
.............
...G.G.G.G...
.G.........G.
.GG.G...G.GG.
......w......
.G...GoG...G.
...G..c..G...
......g......
...G..r..G...
.G...GbG...G.
......p......
.GG.G...G.GG.
.G.........G.
...G.G.G.G...
.............
.............
.............
.............
.............
.............
.............
.............
.............
.............
.............
.............
.............
.............
