.............
.............
.G.G.....G.G.
.GgG.....GgG.
.GcG.....GcG.
.GGG.....GGG.
.............
....pwwwy....
....poooy....
....pcccy....
....pgggy....
....prrry....
....pbbby....
.............
.............
.............
.............
.............
.............
.............
.............
.............
.............
.............
.............
.............
.............
.............
.............
.............


